客户编号	string
客户名称	string
年龄	int
性别	string  男 女 未知
开户年限	int
学历	string  博士后 博士研究生 研究生 大学本科 大学专科 中等专业学校 技术学校  高中 初中 小学 文盲或半文盲 未知
婚姻状况	String  未婚 已婚 初婚 再婚 复婚 已婚有子女 已婚无子女 丧偶 离婚 未知
村民	bool(0或1,代表否或是)
新市民	bool(0或1,代表否或是)
代发客户	bool(0或1,代表否或是)
按揭客户	bool(0或1,代表否或是)
大学生客户	bool(0或1,代表否或是)
股东客户	bool(0或1,代表否或是)
企业主客户	bool(0或1,代表否或是)
AUM余额	float
AUM月日均	float
AUM季日均	float
历史AUM余额	float
存款余额	float
存款月日均	float
存款季日均	float
历史存款余额	float
活期存款余额	float
活期存款月日均	float
活期存款季日均	float
历史活期存款余额	float
普通定期余额	float
普通定期月日均	float
普通定期季日均	float
历史普通定期余额	float
大额存单余额	float
大额存单月日均	float
大额存单季日均	float
历史大额存单余额	float
安心存单余额	float
安心存单月日均	float
安心存单季日均	float
历史安心存单余额	float
理财余额	float
理财月日均	float
理财季日均	float
历史理财余额	float
保险余额	float
保险月日均	float
保险季日均	float
历史保险余额	float
基金余额	float
基金月日均	float
基金季日均	float
历史基金余额	float
积利宝余额	float
积利宝月日均	float
积利宝季日均	float
历史积利宝余额	float
积存金余额	float
积存金月日均	float
积存金季日均	float
历史积存金余额	float
国债余额	float
国债月日均	float
国债季日均	float
历史国债余额	float
高净值产品余额	float
高净值产品月日均	float
高净值产品季日均	float
历史高净值产品余额	float
贷款余额	float
贷款月日均	float
贷款季日均	float
历史贷款余额	float
消费贷款余额	float
消费贷款月日均	float
消费贷款季日均	float
历史消费贷款余额	float
按揭贷款余额	float
按揭贷款月日均	float
按揭贷款季日均	float
历史按揭贷款余额	float
个人经营性贷款余额	float
个人经营性贷款月日均	float
个人经营性贷款季日均	float
历史个人经营性贷款余额	float
网络贷款余额	float
网络贷款月日均	float
网络贷款季日均	float
历史网络贷款余额	float
信用卡贷款月日均	float
信用卡分期余额	float
信用卡分期月日均	float
信用卡分期季日均	float
历史信用卡分期余额	float
持有金融产品个数	int
持有渠道产品个数	int
签约消费渠道个数	int
持有定期存款产品个数	int
持有贷款产品个数	int
持有理财产品个数	int
持有保险产品个数	int
持有基金产品个数	int
持有国债产品个数	int
持有高净值产品个数	int
手机银行近三个月登陆次数	int
客户90天交易频率	int
客户180天交易频率	int
近三月转入金额	float
近三月转入笔数	int
近三月转出金额	float
近三月转出笔数	int
近三月基金买入金额（不含定投）	float
近三月基金买入笔数（不含定投）	int
近三月基金赎回金额	float
近三月基金赎回笔数	int
本月网银跨行转账转出金额 	float
本月手机银行跨行转账转出金额 	float
柜台近3月交易笔数	int
手机银行近3月交易笔数	int
微信近三月转入笔数	int
微信近三月转入金额	float
微信近三月转出笔数	int
微信近三月转出金额	float
支付宝近三月转入笔数	int
支付宝近三月转入金额	float
支付宝近三月转出笔数	int
支付宝近三月转出金额	float
POS近三月转入笔数	int
POS近三月转入金额	float
银银转账近三月转入金额	float
银银转账近三月转出金额	float
风险评级	String  低风险 中低风险 中风险 中高风险 高风险
储蓄产品偏好	string  活期 普通定期  大额存单 结构性存款 智能存款 周周到通知存款
理财产品偏好	string  封闭净值 开放净值 货币净值 周期净值
保险产品偏好	string  分红险 保障险 健康险 定期寿险 终身寿险 意外伤害险 两全保险 年金险 万能险 投资连结险  借款人意外险 其他
基金产品偏好	string  普通基金 股票型基金 混合型基金 货币型基金 债券型基金 QDII基金 组合产品基金 指数基金  FOF基金
交易渠道偏好	string  网银  柜面 手机银行 第三方支付 智能终端